19, 18, 18, 18, 18, 18, 18, 18, 18, 18, 18, 18, 18, 18, 22
17, 16, 16, 16, 16, 24, 16, 16, 16, 16, 16, 16, 16, 16, 20
25, 24, 24, 24, 28, 0, 17, 16, 16, 16, 16, 16, 16, 16, 20
0, 0, 0, 0, 0, 0, 17, 16, 16, 16, 16, 16, 16, 16, 20
19, 18, 18, 18, 18, 18, 16, 16, 16, 16, 24, 24, 24, 24, 20
17, 16, 16, 16, 16, 16, 16, 16, 16, 20, 0, 0, 0, 0, 21
17, 16, 16, 16, 16, 16, 16, 16, 16, 20, 0, 0, 0, 0, 21
17, 16, 16, 16, 24, 16, 16, 16, 16, 20, 0, 0, 0, 0, 21
17, 16, 16, 20, 0, 17, 16, 16, 16, 16, 18, 18, 18, 18, 20
17, 24, 24, 28, 0, 25, 24, 24, 16, 16, 16, 16, 16, 16, 20
21, 0, 0, 0, 0, 0, 0, 0, 17, 16, 16, 16, 16, 16, 20
17, 18, 18, 22, 0, 19, 18, 18, 16, 16, 16, 16, 16, 16, 20
17, 16, 16, 20, 0, 17, 16, 16, 16, 16, 16, 16, 16, 16, 20
17, 16, 16, 20, 0, 17, 16, 16, 16, 16, 16, 16, 16, 16, 20
25, 24, 24, 24, 26, 24, 24, 24, 24, 24, 24, 24, 24, 24, 28